          /
  -+ |    /
   +-+-   /
 | |      /
 +-+-     /
   | #-+  /
 | *   |  /
 +-+ | |  /
   +-+-+  /
          /
