  +----+--- --+- -+-------+--+  +--+ -+ /
  |    |      |   |       |  |  |  ++ | /
  +-+  +  |   |   |  +--+-+  +--+   | | /
    |     |   +---+  |  |        ---+ | /
  +-#--+--+   |    +-+       |      | | /
  |    |           |   -+ +--+--+---+ | /
 -+-+  +--+  +----+  |  | |     |     | /
|   |     |  |    |  |  +-+  +--+ +-+ | /
+-+-+-+   +--+     +-+--     |    | | | /
  |   |   |  +---+ |    +-+--+  --+ | | /
  |       |  |   | | |  |    |      | | /
  ++-+--+    |   +-+ +--+ +--+---+  | | /
   |    |    |          | |      |  | | /
   |  | +--  +--------+   +----+ |  | | /
+--+--+    |          |   |    | |  | | /
|  |  +--+-+--+--+  +-+   + -+ | |  +-+ /
|     |  |    |   | |     |  |   |    | /
+-+   |     ? |   | |  -+-+  | | +----+ /
  |  ++  +--+-+-  |  |  |    | |      | /
+-   |   |  |   | | -+--+- --+-+ -+---+ /
| +--+-- |    +-+-+     |    |    |     /
| |      +----+     +---  ---+ ---+--+  /
| +--+   |          |   |    |       |  /
| |  |   |  | +-  --+-  |    +---+   |  /
|      +-+  | |     |   |        |   |  /
+----+ |  +-+ | +-+-+---+  ---+--+   |  /
     | |  |   | | |      |    |    +-+  /
| +--+ +- |   +-+ + -----+--  +-+--+    /
| |    |  +-+ |   |      |      |  | |  /
| |  +-+    | | | +- -+--+--+ +-+  +-+  /
| |  |   +- | | | |   |     | |    | |  /
| |  | --+  | +-+     |  -+-*-+--+-  +- /
| |  |   |  | | |  +--+   | |    |   |  /
| |  +-+ +--+ | +--+        +--  +-- +- /
| |    | |    |      |      |    |   |  /
+ +-+  +-+-   | +-+- +----+     -+-+ |  /
|   |  |    | | | |       +----+   | |  /
+---+  +----+-  | |  +-+       +---+ |  /
    +--+    |   |    | +-----+       |  /
----+       +---+----+       +-------+  /
