 |        /
-+-#      /
 |        /
 |  | | | /
 | -*-+-+-/
 |  | | | /
-+-    -+-/
 |  |   | /
-+--+---+-/
 |  |   | /
